1111111111111
1001000000BC1
1000C11001001
1P0011E000001
1111111111111