111111111111111111111111111
1E0000000B0010C00000C000001
101001000100000101001001101
10100100101000B000001001101
1P0000000C00C00000000C000C1
111111111111111111111111111