111111111111111111111111111
100C01000000000P0000C000001
101000B00C00100110001011111
100000000000000001000000001
101000000C00B00C00001111001
1C100C0011000000B0000E10C01
111111111111111111111111111