1111111111111
100000E0C0011
1000011111001
1P00000011111
1111111111111