111111
100C01
1P1001
1C00E1
111111