11111111111111111111111111111
1E000000000000C00000C00000001
10100101001000010100100010101
10100100101101000100100010101
1P0000000C00C00000000000000C1
11111111111111111111111111111