11111111111111111111111111
100C0100000000P0000C000001
10100000C00100110001011111
10000000000000001000000001
10100000C00000C00001111001
1C10C001100000000000E10C01
11111111111111111111111111